*****************************
**************---------s----&
**************--------------&
*wwwwwwwwwwwww--*************
******----------*************
******----------wwwwwwwwwwww*
******--*********************
******--*********************
******--*********************
*wwwww--*********************
*p------*********************
*-------*********************
*****************************