*****************************
**************--------------&
**************--------------*
**************--*************
******----------*************
******----------*************
******--*********************
******--*********************
******--*********************
*wwwww--wwwwwwwwwwwwwwwwwwww*
*---s-----------------------*
*--------------------------p*
*****************************