*****************************
*****************************
******wwwwwwwwwwwwww********
******--------------*********
******-------X------*********
******--------------*********
********----------***********
*pwwwwww----------***********
*-----------------***********
*****************************
*****************************
*****************************