*****************************
p-------------******wwwwwwww*
--------------******--------&
************--******--------&
************----------*******
************----------*******
********************--*******
********************--*******
********************--*******
*wwwwwwwwwwwwwwwwwww--wwwwww*
*---s-----------------------*
*---------------------------*
*****************************