*****************************
*********wwwp---------------*
************----------------*
**************************--*
**************************--*
*--wwwwwwwwwwwwwwwwwwwwwww--*
*---------------------------*
*--**************************
*--wwwwwwwwwwwwwwwwwwwwwww--*
*---------------------------*
*--------------------------&w
*--------------------------&-
*****************************