*****************************
*wwwwwwwwwwwww***************
--------------***************
p-------------***************
************----------*******
************----------*******
********************--*******
********************--------&
********************--------&
*****************************
*****************************
*****************************