*************************&&**
*wwwwww**wwwwww**wwwwww**--**
*------**------**------**--**
*--**--**--**--**--**--**--**
*--**--**--**--**--**--**--**
*--**--**--**--**--**--**--**
*--**--**--**--**--**--**--**
*--**--**--**--**--**--**--**
*--**--**--**--**--**--**--**
*--**--**--**--**--**--**--**
*--**--ww--**--ww--**--ww--**
*p-**------**------**------**
*****************************