*****************************
p-------------***************
--------------***************
************--***************
************----------*******
************----------*******
********************--*******
********************--*******
********************--*******
*wwwwwwwwwwwwwwwwwww--wwwwww*
&&--s-----------------------*
&&--------------------------*
*****************************