*****************************
wwwwwwwwwwwwwwwwwwwwwwwwwwwww
*****************************
wwwwwwwwwwwwwwwwwwwwwwwwwwwww
*****************************
wwwwwwwwwwwwwwwwwwwwwwwwwwwww
*****************************
wwwwwwwwwwwwwwwwwwwwwwwwwwwww
*****************************
wwwwwwwwwwwwwwwwwwwwwwwwwwwww
*p--------------------------&
w----------------------------
*****************************
