*****************************
*p--------------------------*
*---------------------------*
w*************************--*
**************************--*
*wwwwwwwwwwwwwwwwwwwwwwwww--*
******-----------*********--*
*wwwww-----------wwwwwwwww--*
****----*******--********---*
*www--**wwwwwww--wwwwwwww---*
*-----ww------*-------------*
*-------------w-------------*
***********&&&***************